{
    'HLA-A':
        [
            'HLA-A*01:01',
            'HLA-A*01:03',
            'HLA-A*02:01',
            'HLA-A*02:02',
            'HLA-A*02:03',
            'HLA-A*02:04',
            'HLA-A*02:05',
            'HLA-A*02:06',
            'HLA-A*02:07',
            'HLA-A*02:08',
            'HLA-A*02:09',
            'HLA-A*02:10',
            'HLA-A*02:11',
            'HLA-A*02:12',
            'HLA-A*02:14',
            'HLA-A*02:16',
            'HLA-A*02:17',
            'HLA-A*02:19',
            'HLA-A*02:50',
            'HLA-A*03:01',
            'HLA-A*03:02',
            'HLA-A*03:19',
            'HLA-A*11:01',
            'HLA-A*11:02',
            'HLA-A*23:01',
            'HLA-A*24:02',
            'HLA-A*24:03',
            'HLA-A*24:06',
            'HLA-A*24:07',
            'HLA-A*24:13',
            'HLA-A*25:01',
            'HLA-A*26:01',
            'HLA-A*26:02',
            'HLA-A*26:03',
            'HLA-A*29:01',
            'HLA-A*29:02',
            'HLA-A*30:01',
            'HLA-A*30:02',
            'HLA-A*30:03',
            'HLA-A*30:04',
            'HLA-A*31:01',
            'HLA-A*32:01',
            'HLA-A*32:07',
            'HLA-A*32:15',
            'HLA-A*33:01',
            'HLA-A*33:03',
            'HLA-A*34:01',
            'HLA-A*34:02',
            'HLA-A*36:01',
            'HLA-A*66:01',
            'HLA-A*66:02',
            'HLA-A*68:01',
            'HLA-A*68:02',
            'HLA-A*68:23',
            'HLA-A*69:01',
            'HLA-A*74:01',
            'HLA-A*80:01'
        ],


     'HLA-B':
        [
            'HLA-B*07:02',
            'HLA-B*07:04',
            'HLA-B*08:01',
            'HLA-B*08:02',
            'HLA-B*08:03',
            'HLA-B*13:01',
            'HLA-B*13:02',
            'HLA-B*14:01',
            'HLA-B*14:02',
            'HLA-B*14:03',
            'HLA-B*15:01',
            'HLA-B*15:02',
            'HLA-B*15:03',
            'HLA-B*15:08',
            'HLA-B*15:09',
            'HLA-B*15:10',
            'HLA-B*15:11',
            'HLA-B*15:13',
            'HLA-B*15:16',
            'HLA-B*15:17',
            'HLA-B*15:18',
            'HLA-B*15:42',
            'HLA-B*18:01',
            'HLA-B*18:03',
            'HLA-B*27:01',
            'HLA-B*27:02',
            'HLA-B*27:03',
            'HLA-B*27:04',
            'HLA-B*27:05',
            'HLA-B*27:06',
            'HLA-B*27:07',
            'HLA-B*27:08',
            'HLA-B*27:09',
            'HLA-B*27:10',
            'HLA-B*27:20',
            'HLA-B*35:01',
            'HLA-B*35:02',
            'HLA-B*35:03',
            'HLA-B*35:04',
            'HLA-B*35:06',
            'HLA-B*35:07',
            'HLA-B*35:08',
            'HLA-B*37:01',
            'HLA-B*38:01',
            'HLA-B*38:02',
            'HLA-B*39:01',
            'HLA-B*39:05',
            'HLA-B*39:06',
            'HLA-B*39:09',
            'HLA-B*39:10',
            'HLA-B*39:24',
            'HLA-B*40:01',
            'HLA-B*40:02',
            'HLA-B*40:06',
            'HLA-B*40:13',
            'HLA-B*41:01',
            'HLA-B*41:02',
            'HLA-B*41:03',
            'HLA-B*41:04',
            'HLA-B*41:05',
            'HLA-B*41:06',
            'HLA-B*42:01',
            'HLA-B*42:02',
            'HLA-B*44:02',
            'HLA-B*44:03',
            'HLA-B*44:05',
            'HLA-B*44:08',
            'HLA-B*44:09',
            'HLA-B*44:27',
            'HLA-B*44:28',
            'HLA-B*45:01',
            'HLA-B*45:06',
            'HLA-B*46:01',
            'HLA-B*47:01',
            'HLA-B*48:01',
            'HLA-B*49:01',
            'HLA-B*50:01',
            'HLA-B*50:02',
            'HLA-B*51:01',
            'HLA-B*51:02',
            'HLA-B*51:08',
            'HLA-B*52:01',
            'HLA-B*53:01',
            'HLA-B*54:01',
            'HLA-B*55:01',
            'HLA-B*55:02',
            'HLA-B*56:01',
            'HLA-B*57:01',
            'HLA-B*57:02',
            'HLA-B*57:03',
            'HLA-B*58:01',
            'HLA-B*58:02',
            'HLA-B*73:01',
            'HLA-B*81:01',
            'HLA-B*83:01'
        ],

     'HLA-C':
        [
            'HLA-C*01:02',
            'HLA-C*02:02',
            'HLA-C*03:02',
            'HLA-C*03:03',
            'HLA-C*03:04',
            'HLA-C*03:07',
            'HLA-C*04:01',
            'HLA-C*04:03',
            'HLA-C*05:01',
            'HLA-C*06:02',
            'HLA-C*07:01',
            'HLA-C*07:02',
            'HLA-C*07:04',
            'HLA-C*07:06',
            'HLA-C*08:01',
            'HLA-C*08:02',
            'HLA-C*08:03',
            'HLA-C*12:02',
            'HLA-C*12:03',
            'HLA-C*12:04',
            'HLA-C*14:02',
            'HLA-C*14:03',
            'HLA-C*15:02',
            'HLA-C*15:05',
            'HLA-C*16:01',
            'HLA-C*17:01'
        ]
 }